5 10
|--------|
|.F.|..-.|
|..-|.@D.|
|.F....-.|
|--------|